scaffold_121	reverse	gggttaggttagggttagggttaggttagggttagggttagggttagggttagggttagggttagggttagggttagggttaggttagggttagggttag
scaffold_502	forward	CCTAACCTAACCCTAGCCTAACTACTTCTTCTGCTTCTTCTTCAACCCTAGCCTAGCCTAACCTAACCCTAACTTCTTCTTCTTCTTCTTCTTCTTCTTC
scaffold_730	forward	ctaacctaacctaacctaacctaaccctaaccctaacctaacctaaccctaacctaaccctaacctaacctaaccctaacctaaccctaacctaacctaa
scaffold_770	forward	CCTAAccctaaccctaaccctaacctaacctaaccctaacctaaccctaacctaacctaaccctaacctaacctaacctaaccctaaccctaaccctaac
scaffold_888	forward	AACCTAACCTAACCTAACCCACAACCCTAGCGCAACCTGGCTGGCCCTATTTGCTGAGCTGTTTTCTTCAACCTAGCCTGCTTCTTCAACCTAATCAGCC
scaffold_896	forward	ctaaccctaacctaaccctaacctaaccctaacctaacctaacctaaccctaacctaacctaaccctaaccctaaccctaaccctaacctaacctaaccc
scaffold_1089	forward	TAACCTAAccctaaccctaacctaacctaacctaaccactgctctaaccctaaccctaaccctaaccctaaccctaaccctaaccctaaccctaacccta
scaffold_1653	reverse	gtgttttgttcccccttgatccactctttctctatgttgcaagctttggcgccatcaaccttggaggggttagttacaagaggaggttttgtggggacAT
scaffold_1699	reverse	ggttagggttagggttagggttagggttagggttagggttagggttagggttagggttagggttagggttagggttagggttagggttagggttagggTT
scaffold_1721	forward	TATGGACAATGGTAACTAACTCTTAGTCATAGATGTGATATTTATGTTCACCATCTGAGATTCTGAGATCCTTATGCAACAGGAGGAGATACTTTATGGC
scaffold_1729	reverse	gaaaatttaccaaacaatatttgaagccaaattggtggttagttatcagctctatgtggatttgggctttatctctcaccacttagacacagcttcatac
scaffold_1845	reverse	ctaatcattgcacgcagattaatcgctacacgctgtattactggtcatcatttattaataatgttggcagttatacgccatgtaattgttagTTAATTAG
scaffold_1921	reverse	ATGAAACTGCAAGAGTTAGTTAACAAATTCCTCCCACAATTCATCACATAAGAAGCAAAAATTCCCATGGCCAATATTGGTAAACACATTGTCAAAACTG
scaffold_2059	reverse	ccagaattttattctgaagatacgttgatgttgtcccaggccgtttatcttgggctactttggttagggttaattgttctgcttaatcctggtattacaa
scaffold_2510	forward	tggtccaacctatataacactgagtacaaaataaaagggaaagatccctccacacactaactaacccatgatacattagtagggaatgaaaaatatttcc
scaffold_2712	reverse	gggttagggttagggttagggttagggttagggttagggttagggttagggttagggttagggttagggttagggttagggttagggttagggttagggT
scaffold_3113	forward	cctaacctaaccctaacctaacctaacctaacctaaccctaaccctaacctaacCCTAACCTAACCTAACCTAACCTAACCTAACCTAACCTAACCTAAC
scaffold_3281	reverse	gggttagggttagggttagggttagggttagggttagggttagggttagggttagggttagggttagggttagggttagggttagggttagggttagggt
scaffold_3601	forward	AGAGTAACTAACCAAGggagaaagatccaggcagtgagttgataatactcctggtctgggatgtataaagatggaactggtagaaggggggaatatctgg
scaffold_3832	forward	aaacggaaactcaactccccctctgtttgactctatccacttgccacgtgatcagtttcagatttaactaaccaaagtctcagaattaaggctaaattaa
scaffold_3999	reverse	agggttgtggttagggttagggttagggttagggttagggttagggttagggttagggttagggttagggttagggttagggttagggttagggttaggg
scaffold_4065	forward	AAccctaaccctaaccctaaccctaaccctaaccctaaccctaaccctaaccctaaccctaaccctaaccctaaccctaaccctaaccctaaccctaacc
scaffold_4344	reverse	gggttaggttaggttaggttagagaagttaggttaggttaggttagggttaggttaggttaggttaggttaggttagagttaggttagggttaggttagg
scaffold_5206	forward	gtctccagattgatttggccaatattgcatttatcctgctagttagtttggcctaactaacaagtcaatattttattatgcttttcatataggtaccaag
scaffold_5334	reverse	gggttagggttagggttagggttaggttagggttagggttagggttagggttagggttaggttagggttaggttagagCAATACGTAACTGAACGAAGTA
scaffold_5665	reverse	gttaggttaggttagaagttaggttagggttaggttaggaaggttagggttagggttaggttaggttaggagttaggttaggttaggttagggttaggTT
scaffold_5714	reverse	ttagggttagggttagggttagggttaggttaggttagggttaggttaggttagggttagggttagggttagggttaggAGCAATACGTAACTGAACGAA
scaffold_5852	reverse	ctccatttattgcatacatggtatattgctagcaatttcttattgtatatagggtacctctgctcagtgttagttagttttctactcttgtaacatactg
scaffold_6042	reverse	tgctgtaataggttagggttagggttatggttaggttaggttagggttagggtttaggtttgtattagggttaggttaggttagggttaggttaggttag
scaffold_6315	forward	cacccagttccttagggaatataatgggataactaacttaaaagatggttgcctctctattctgggatatgaagtccccctgatctttgaagagccagtc
scaffold_6583	forward	CCTAAccctaaccctaaccctaaccctaaccctaaccctaaccctaaccctaaccctaaccctaaccctaaccctaaccctaaccctaaccctaacccta
scaffold_7182	reverse	gttagggttagggttagggttagggttagggttagggttggggttagggttagggttagggttagggttagggttagggttagggttagggttagggtta
scaffold_7635	reverse	agttggcctccttggttgttaggttagtggggaggccatcaggagttcACACTGTTATAGTAGAACAATAAATGAAGGAAATAGCATAACCTTGGAAGGG
scaffold_7768	reverse	ttaaagggttaggttaggttaggttagaagaagaagaagaaataggttaggttggtgttagCATGAAAGAAGAAAATAGTAAGAAGTAGGTTAGGTTAGG

Telomeres found: 34 (15 forward, 19 reverse)
