scaffold_3	forward	cctaaccctaaccctaaccctaaccctTAAGGAACTCTGTTTACGCAAATTAGAGAAAATTTTAACTTTTTAAAATTTTTTATTTTTTACAAAACAAATT
scaffold_30	forward	CCTaaccctaaccctaatccaacaaaaatactgaaaattctaaagctcataacttcttcctagggcaaccaatcacaattcccgcctatttttggtgtca
scaffold_39	forward	aaattgataaactaaatatggctaactccaagttaatagtaaatgagtttaactaactaggacaacctaatctcagaaaaccaaatcttggattataact
scaffold_39	reverse	attctggctaaacctaccagtcataatctgagatttggttttccaagattaggttgtcctagttagttaaactcatttactattaactcagagttagcta
scaffold_85	forward	cctaaccctaaccctaaccctaaccctaaccctaaccctaaccctaaccctaaccctaaccctTAAGGAACTCTGTTTACGCAAATTAGAGAAAATTTTA
scaffold_138	forward	cctaaataaaacccattaaatcctaaccctaaccctaacccaacaaaaatactaaaattccgaagctcataacttcttcctagggtaaccaatcacaaat
scaffold_174	reverse	aattctttttttctcggaccttcggccctcgaaaaaacaacaacagttagttagaataggccaagaccaaacttcttttttttacggaccttcggcccgt
scaffold_184	forward	CCAATCATTATTTACTACGCAACTCGATCTTCCTAACCAGTTAACTAACATCCAGTGAAGTGAAAGGGATTTATAGATCTATCTGCAGTCGAACTGGATT
scaffold_195	reverse	tttTTgttagggttagggttagggttagggttagggttagggttagggttagggttagggttagggttagggttagggttagggttagggttagggttag
scaffold_212	reverse	cagagtaacaccaaaaataggcaggaattgtgattggttgccctaggaagaagttatgagctttggaatttttagtatttttgttagggttagggttagg
scaffold_293	reverse	agggttagggttaggatttaatgggtttttatttaggaaaataaaagaaaggactctttaaaaggaggatagggagggggggcaagagggggaggggaga
scaffold_304	reverse	tttgAtagggttagggttagggttagggttagggttagggttagggttagggttagggttagggttagggttagggttagggttagggttagggttaggg
scaffold_479	reverse	gccctcaaaaaaaaacaacaacagttagttagaataggccaagaccaaacttcttttttttacggaccttcggcccgtaaaaaaaacataaaatttgagg
scaffold_538	reverse	tagggttagggttaggatttaatgggtttttattttggaaaataaaagaaaggactctttaaaaggaggatagggagggggggcaagagggggaggggag
scaffold_697	forward	ATATTAAAGTCTAGTTTAAGGTCCGAAATTAACCCCCCTAACCGTCACTTGGAATCACGCTAAAGTGTTACTAAATCGGCAAACTATAGTTTCGATAGTA
scaffold_739	forward	aaccctaaccctaaccctaaccctaaccctaaccctaaccctaaccctaaccctaaccctaaccctaaccctaaccctaaccctaaccctaacccAACAA
scaffold_859	reverse	gcattggaaatttagtgattttgAtagggttagggttagggttagggttagggttagggttagggttagggttagggttagggttagggttagggttagg
scaffold_1024	forward	ctcccctccccctcttgcccccccctccctatcctccttttaaagagtcctttcttttattttcctaaataaaacccattaaatcctaaccctaacccta
scaffold_1031	forward	gcctgttttcagccttcctcacaaggataatatgtttttgagataataaccgcttttactaagtataataatgaaacagattatcaaattataactaact
scaffold_1440	forward	AACTAGCATCCCTCATTAAAAGCTTTAATGACCATCTTTATAATCCCAGACATTACTCTATAGACTGTACCTAACTAACTAAGTTTTCAGGCAGGATTTT
scaffold_1628	reverse	tagggttagggttaggatttaatgggttttatttaggaaaataaaagaaaggactctttaaaaggaggatagggaggggggggcaagagggggaggggag
scaffold_1725	forward	ATAGTTTATGACTAATTGTGTTTCTTTAGTTTTCAGTGATTGACACCTAGAAATTTATTAATGACTGAAAAAAAAGTCCCTAACTAACCTAGAGAAATTT
scaffold_2119	reverse	ttacgttattaaacaaaacactatttgttatgttagttagtatgagcaaggcttgtcacatggatagaatgggttctacttgttgcgttaatgaaCTACT
scaffold_2176	reverse	TTTAAGTTTTATCAAGTTTTGAGGGTTGATAGGGTGTGAGTAAAGTTAGGTTAGGGGTGAGAGGGTTGGGGTAGGGGGTTTTAAGGTTGGGGAGGGGGAG
scaffold_2331	forward	TCATATTTTTACATCAGTTTTGTATTAAGATCAACTATATCATACCTGTTTAAGCCAGTGAAAGCGTATTCGTAACAAACCAACCCTCCCTaaccctaac
scaffold_2423	reverse	tatactctttattgttagttattaaggaaattggggggtaatatagtaatgtataaaagaactaacaagaaatattccgtgaatagcaacaaatagaaaA
scaffold_2457	reverse	cccacaaaaaaaacaacaacagttagttagaataggccaagaccaaacttcttttttttacggaccttcggcccgtaaaaaaaaacataaaatttgaggc
scaffold_2506	forward	TATGTTTTATAATTTCTATATTtaagggccattggggtggaattatctaatagtatgaggactaaaagatattaaggctctataactaacttataatata
scaffold_2893	forward	Tcaataagaaaaagtaagatattattataactaaccataaatagaaaaataggaagaattctaaggacaggtgacgtcacataatcttgttaacaagttg
scaffold_3118	forward	aaattcaaagaagtttttaaagagaaattgcctgaattaccttaactaaccatttaataaaacatgagattgagttgaaagccactattaccaagccaaa
scaffold_3497	forward	CCTTTtatccaaagaaaccaactaaaataggtaattacatccaataatttttgatagacaataactaactgctttgattagacaagcacaaacttcacat
scaffold_3592	forward	TGTCAGTACAAGATGAAAGATAAATTTAAACTAGGAAATTTTAATCCAAAAGAGACAAAATATGGTATATTAACCCTAACACTGCCAAACTACAAACCAG
scaffold_3657	forward	accctaaccctaaccctaaccctaaccctaaccctaaccctaaccctaaccctaaccctaaccctaaccctaaccctaaccctaaccctaaccctTAAGA
scaffold_3971	forward	acttatgagaataatgtctaaacaaaaagggtaactaacaaaattatctttatttttagaggaagagaatgtgttagtggaggaggaagtaggttcttct
scaffold_4157	forward	accctaaccctaaccctaaccctaaccctaaccctaaccctaaccctaaccctaaccctaaccctaaccctaaccctaaccctaaccctaaccctTAAGG
scaffold_4459	reverse	AATGATGATGGTTGATAATGAATATAATTTTTAGAATCTATAGGGGAGAGTGGTTAGGTTACTTGTTAACTTTTTAAGCAATTATAAGGATAGTGATAAT
scaffold_4600	forward	CCCCTCTTCCCCCTCTCCTCCCCTTTCTTTCCCCTCTAGCCAACCCTACCCTATCAACCTAACTAACCAATCTTTACCCTTCTATCCCCCCTCTCCCCTA
scaffold_4868	reverse	GATGAGGAGAGAGATATAGAGAGGGATATAGAGAGAGTTAGTTAAAGGGATGATAAGAAGGTTAGTTAGAGGGATGTAGAGAGAGTTAGTTAAAGGGATG
scaffold_5089	forward	aaaacttaactaacaacgtgatttctttataatcagaatgaaataaaatatcttgagaataaaatgtagaaatattcttaataatccttttctttttatt
scaffold_5190	forward	AGATgaaaatgtatataatgcacttaagtttgtattttttgaaaggtcaagagaaatagttaatgactaactaacaaggaagaagagagagcttcttttg
scaffold_5430	reverse	GGGAGGATAGAAAGGGTAGAGGTGGGATGAAATTCATTAATTAGGAGGGGGGTTAGTTAGTTGGGGTAAATAGGAGGGAGGGGGACTAAAGTTGGGGAGG
scaffold_5533	reverse	tccaatgaatctttggacattgttgccagtatgttaggttaccacttaggctacaggccatttagttgcatgatattcacaattgttatggaccttttgt
scaffold_5911	forward	attaaatcctaaccctaaccctaacaaaaattactaaaattcaaaagctcataacttcttcctagggcaaccaatcacaaatcctgcctatttttggtgt
scaffold_5999	reverse	tttgAtagggttagggttagggttagggttagggttagggttagggttagggttagggttagggttagggttagggttagggttagggttagggttaggg
scaffold_6028	reverse	ATGAGTCTAATTGATAAAGAAGGTAGTTGATAAAGATAATAATAAAGTTAGTTATCCTCAAAAATGGGGAGGGGGATGAAATTCTTTTTCACCTACTACC
scaffold_6112	reverse	AACATTTTTTATTGGATTACATATATTTTAAAGTACTATCAGATATAAGGTAATAGTGTGAATTAAAGATAGGATGTTAGTTAATATAGGTTAAAAATTA
scaffold_6153	reverse	gtttttattctcaagatattatttttcattctgattgtaaagaaatcacgttgttagttaatttttcccctaggaatcatatttgttttccacccaagag
scaffold_6529	forward	AAAGatttgataaagattaactaaccttttgtattgttacttttttgtatacaattggttggttgtaaaacttaataacaaaaaagactaagaaaaaata
scaffold_6852	forward	TAACGCAACAAGTAGaacctgctctatccacgtgataagccttgctcattttaactaacttaacaaacattgtttgttataaaacataatgaacccaaac
scaffold_6963	forward	aggtattttattgtttttgtatataactaaccagaaaatctttgacaccttacctgaaagtaggctcttaattctttttaataaattaaacttcatttta
scaffold_7000	forward	agaaaaagtaagatattattataactaaccatatatagaaagataggaagaattctaaggacaggtgacgtcacataatctcattaacaagttagcataa
scaffold_7308	forward	GTCAAAAACTTAACTAACATAATCAGTAAGTAGATGTTTCTCTTCCCCTCTTAAAGATTGTGGAGAGTCTACTACCTTAGCAAACctacttgttgtagta
scaffold_7421	forward	GCTAtaagcaacaaaggaatatttccagatccagaaaagatcttggcagtaactaacctaccaaggccaacagacaccaaacaactaaaatcctttcttg
scaffold_7630	reverse	tatttaaagaaagttattgtgctcaagagttagttaatattactataagattatgttgtcaggggaagggagtctcatagaatgaagacaaagggataat
scaffold_7707	reverse	aaccaatgcaagttctatcttgactcataacagctttgtagagtctcagagggatgaagttagttatgaagcagaagttttgagtgactcattactcaaa
scaffold_7709	forward	ttgtaactcttataacaaacaactgacgggctcataacagataactaacatacccattgcaagggatcccaggaactgacggggccaaggaaccacaagg
scaffold_7850	reverse	AATTAGTAAGAAGCTATAGACTAAGTTAGTTATCTAAAGGATTGGATCAATTTAGACTTAAGCAATAAAGTAGTGTATAAGTTGAAAAAAAAGGAACCAG
scaffold_7931	forward	AGTATATTttttaacgtttattaatggtcaataactaactgccataataattgtttaggaaaaatgattcaggttttatgtttaattaattagtaattaa
scaffold_8455	reverse	ggttacttatcaaatgacctaaaaagttagttaagttttttagaattttatctagatgtcttagcaaataaattattgtggaaaagaatgtAATTTTTTG
scaffold_8539	forward	tttctcaaaactttcaaacttcagactcaaggattgtctgaggataggatgatctctttatttgggggtctgatgtcatacggggtaactaactggtttt

Telomeres found: 60 (34 forward, 26 reverse)
